
1600 1152 36 50 32 32 800 576 

5 

0 0 0 
1 32 0 
2 64 0 
3 96 0 
4 128 0 

 0 0 0 0 0 0 0 0 0 0 0 0 0 0 0 0 0 0 0 0 0 0 0 0 0 0 0 0 0 0 0 0 0 0 0 0 0 0 0 0 0 0 0 0 0 0 0 0 0 0 
 0 1 1 1 1 1 1 1 1 1 1 1 2 2 2 2 2 2 2 3 3 3 3 0 0 4 4 4 4 4 4 0 0 3 3 3 1 1 1 0 0 1 1 0 0 3 3 3 1 0 
 0 1 1 1 1 1 1 1 1 1 1 1 2 2 2 2 2 2 2 3 3 3 3 0 0 4 4 4 4 4 4 0 0 3 3 3 1 1 1 0 0 1 1 0 0 3 3 3 1 0 
 0 1 1 0 0 1 1 0 0 1 1 0 0 2 2 0 0 2 2 0 0 3 3 0 0 4 4 0 0 4 4 3 3 3 3 0 0 1 1 1 1 1 1 0 0 3 3 3 1 0 
 0 1 1 0 0 1 1 0 0 1 1 0 0 2 2 0 0 2 2 0 0 3 3 0 0 4 4 0 0 4 4 3 3 3 3 0 0 1 1 1 1 1 1 0 0 3 3 3 1 0 
 0 1 1 1 1 1 1 1 1 1 1 1 2 2 2 2 2 2 2 3 3 3 3 0 0 4 4 4 4 4 4 0 0 3 3 3 1 1 1 0 0 1 1 0 0 3 3 3 1 0 
 0 1 1 1 1 1 1 1 1 1 1 1 2 2 2 2 2 2 2 3 3 3 3 0 0 4 4 4 4 4 4 0 0 3 3 3 1 1 1 0 0 1 1 0 0 0 3 3 0 0 
 0 1 1 0 0 1 1 0 0 1 1 0 0 2 2 0 0 2 2 0 0 3 3 0 0 4 4 0 0 4 4 3 3 3 3 0 0 1 1 1 1 1 1 0 0 0 3 3 0 0 
 0 1 1 0 0 1 1 0 0 1 1 0 0 2 2 0 0 2 2 0 0 3 3 0 0 4 4 0 0 4 4 3 3 3 3 0 0 1 1 1 1 1 1 3 3 3 3 3 1 0 
 0 1 1 1 1 1 1 1 1 1 1 1 2 2 2 2 2 2 2 3 3 3 3 0 0 4 4 4 4 4 4 0 0 3 3 3 1 1 1 0 0 1 1 3 3 3 3 3 1 0 
 0 1 1 1 1 1 1 1 1 1 1 1 2 2 2 2 2 2 2 3 3 3 3 0 0 4 4 4 4 4 4 0 0 3 3 3 1 1 1 0 0 1 1 0 0 0 3 3 0 0 
 0 2 2 0 0 2 2 0 0 2 2 0 0 2 2 0 0 2 2 0 0 1 1 0 0 3 3 0 0 3 3 3 3 3 3 0 0 1 1 1 1 1 1 0 0 0 3 3 0 0 
 0 2 2 0 0 2 2 0 0 2 2 0 0 2 2 0 0 2 2 0 0 1 1 0 0 1 1 0 0 1 1 1 1 1 1 0 0 1 1 1 1 1 1 0 0 1 1 1 2 0 
 0 2 2 2 2 2 2 2 2 2 2 2 2 2 2 2 2 2 2 1 1 1 1 0 0 1 1 1 1 1 1 0 0 1 1 1 1 1 1 0 0 1 1 0 0 1 1 1 2 0 
 0 2 2 2 2 2 2 2 2 2 2 2 2 2 2 2 2 2 2 1 1 1 1 0 0 1 1 1 1 1 1 0 0 1 1 1 1 1 1 0 0 1 1 0 0 1 1 1 2 0 
 0 2 2 0 0 2 2 0 0 2 2 0 0 2 2 0 0 2 2 0 0 1 1 0 0 1 1 0 0 1 1 1 1 1 1 0 0 1 1 1 1 1 1 0 0 1 1 1 2 0 
 0 2 2 0 0 2 2 0 0 2 2 0 0 2 2 0 0 2 2 0 0 1 1 0 0 1 1 0 0 1 1 1 1 1 1 0 0 1 1 1 1 1 1 0 0 1 1 1 2 0 
 0 2 2 2 2 2 2 2 2 2 2 2 2 2 2 2 2 2 2 1 1 1 1 0 0 1 1 1 1 1 1 0 0 1 1 1 1 1 1 0 0 1 1 0 0 1 1 1 2 0 
 0 2 2 2 2 2 2 2 2 2 2 2 2 2 2 2 2 2 2 1 1 1 1 0 0 1 1 1 1 1 1 0 0 1 1 1 1 1 1 0 0 1 1 0 0 0 1 1 0 0 
 0 2 2 0 0 2 2 0 0 2 2 0 0 2 2 0 0 2 2 0 0 1 1 0 0 4 4 0 0 4 4 4 4 4 4 0 0 3 3 3 3 3 4 0 0 0 4 4 0 0 
 0 2 2 0 0 2 2 0 0 2 2 0 0 2 2 0 0 2 2 0 0 1 1 0 0 4 4 0 0 4 4 4 4 4 4 0 0 3 3 3 3 3 4 0 0 4 4 4 3 0 
 0 2 2 2 2 2 2 2 2 2 2 2 2 2 2 2 2 2 2 1 1 1 1 0 0 4 4 4 4 4 4 0 0 4 4 3 3 3 3 0 0 3 4 0 0 4 4 4 3 0 
 0 2 2 2 2 2 2 2 2 2 2 2 2 2 2 2 2 2 2 1 1 1 1 0 0 4 4 4 4 4 4 0 0 4 4 3 3 3 3 0 0 3 4 0 0 4 4 4 3 0 
 0 1 1 0 0 1 1 0 0 1 1 0 0 2 2 0 0 2 2 0 0 3 3 0 0 4 4 0 0 4 4 4 4 4 4 0 0 3 3 3 3 3 4 0 0 4 4 4 3 0 
 0 1 1 0 0 1 1 0 0 1 1 0 0 2 2 0 0 2 2 0 0 3 3 0 0 4 4 0 0 4 3 3 3 3 3 0 0 1 1 1 1 1 3 0 0 3 3 1 1 0 
 0 1 1 1 1 1 1 1 1 1 1 2 2 2 2 2 2 2 2 3 3 3 3 0 0 4 4 4 4 4 3 0 0 3 3 1 1 1 1 0 0 1 3 0 0 0 0 1 1 0 
 0 1 1 1 1 1 1 1 1 1 1 2 2 2 2 2 2 2 2 3 3 3 3 4 4 4 4 4 4 4 3 0 0 3 3 1 1 1 1 0 0 1 3 0 0 0 0 1 1 0 
 0 1 1 0 0 1 1 0 0 1 1 0 0 2 2 0 0 2 2 0 0 3 3 4 4 4 4 0 0 4 3 3 3 3 3 0 0 1 1 1 1 1 3 0 0 3 3 1 1 0 
 0 1 1 0 0 1 1 0 0 1 1 0 0 2 2 0 0 2 2 0 0 3 3 0 0 4 4 0 0 4 3 3 3 3 3 0 0 1 1 1 1 1 3 0 0 3 3 1 1 0 
 0 1 1 1 1 1 1 1 1 1 1 2 2 2 2 2 2 2 2 3 3 3 3 0 0 4 4 4 4 4 3 0 0 3 3 1 1 1 1 0 0 1 3 0 0 3 3 0 0 0 
 0 1 1 1 1 1 1 1 1 1 1 2 2 2 2 2 2 2 2 3 3 3 3 0 0 4 4 4 4 4 3 0 0 3 3 1 1 1 1 0 0 1 3 0 0 3 3 0 0 0 
 0 1 1 0 0 1 1 0 0 1 1 0 0 2 2 0 0 2 2 0 0 3 3 0 0 3 3 0 0 3 1 1 1 1 1 0 0 1 1 1 1 1 1 0 0 1 1 2 2 0 
 0 1 1 0 0 1 1 0 0 1 1 0 0 2 2 0 0 2 2 0 0 3 3 0 0 3 3 0 0 3 1 1 1 1 1 0 0 1 1 1 1 1 1 0 0 1 1 2 2 0 
 0 1 1 1 1 1 1 1 1 1 1 2 2 2 2 2 2 2 2 3 3 3 3 0 0 3 3 3 3 3 1 0 0 1 1 1 1 1 1 0 0 1 1 0 0 1 1 2 2 0 
 0 1 1 1 1 1 1 1 1 1 1 2 2 2 2 2 2 2 2 3 3 3 3 0 0 3 3 3 3 3 1 0 0 1 1 1 1 1 1 0 0 1 1 0 0 1 1 2 2 0 
 0 0 0 0 0 0 0 0 0 0 0 0 0 0 0 0 0 0 0 0 0 0 0 0 0 0 0 0 0 0 0 0 0 0 0 0 0 0 0 0 0 0 0 0 0 0 0 0 0 0 

