
1024 704 22 32 32 32 

4 

0 0 0 
1 32 0 
2 64 0 
3 96 0 

 0 0 0 0 0 0 0 0 0 0 0 0 0 0 0 0 0 0 0 0 0 0 0 0 0 0 0 0 0 0 0 0 
 0 0 0 0 0 0 0 0 0 0 0 0 0 0 0 0 0 0 0 0 0 0 0 0 0 0 0 0 0 0 0 0 
 0 0 1 1 1 0 1 1 1 1 0 0 2 2 2 2 0 2 2 2 2 2 2 0 1 1 1 0 1 1 0 0 
 0 0 1 0 1 1 1 0 1 1 0 0 2 2 0 2 2 2 0 2 0 0 2 2 1 0 1 1 1 1 0 0 
 0 0 1 1 1 0 1 1 1 0 0 0 0 2 2 2 0 2 2 2 0 0 2 0 1 1 1 0 1 0 0 0 
 0 0 1 0 1 1 1 0 1 1 0 0 2 2 0 2 2 2 0 2 0 0 2 2 1 0 1 0 1 1 0 0 
 0 0 1 1 1 0 1 1 1 0 0 0 0 2 2 2 0 2 2 2 0 0 2 0 1 1 1 0 1 0 0 0 
 0 0 1 0 1 1 1 0 1 1 0 0 2 2 0 2 2 2 0 2 0 0 2 2 1 0 1 0 1 1 0 0 
 0 0 1 1 1 0 1 1 1 0 0 0 0 2 2 2 0 2 2 2 0 0 2 0 1 1 1 0 1 0 0 0 
 0 0 1 0 1 1 1 0 1 1 1 1 2 2 0 2 2 2 0 2 0 0 2 2 1 0 1 0 1 1 0 0 
 0 0 0 0 0 0 0 0 0 1 0 0 2 0 0 0 0 0 0 0 0 0 2 0 1 1 1 1 1 0 0 0 
 0 0 0 0 0 0 0 0 0 2 0 0 2 0 0 0 0 0 0 0 0 0 2 2 1 0 1 0 1 1 0 0 
 0 0 0 2 0 2 0 2 0 2 2 2 2 0 2 0 2 0 2 0 0 0 2 0 2 2 2 0 2 0 0 0 
 0 0 2 2 2 2 2 2 2 2 0 0 2 2 2 2 2 2 2 2 0 0 2 2 2 0 2 0 2 2 0 0 
 0 0 2 0 2 0 2 0 2 0 0 0 0 2 0 2 0 2 0 2 0 0 2 0 2 2 2 0 2 2 0 0 
 0 0 2 2 2 2 2 2 2 2 0 0 2 2 2 2 2 2 2 2 0 0 2 2 2 0 2 0 2 2 0 0 
 0 0 0 2 0 2 0 2 0 2 0 0 2 0 2 0 2 0 2 0 0 0 2 0 2 2 2 0 0 0 0 0 
 0 0 2 2 2 2 2 2 2 2 0 0 2 2 2 2 2 2 2 2 0 0 2 2 2 0 2 2 2 2 0 0 
 0 0 2 0 2 0 2 0 2 2 0 0 2 2 0 2 0 2 0 2 0 0 2 0 2 2 2 2 2 2 0 0 
 0 0 2 2 2 2 2 2 2 2 0 0 2 2 2 2 2 2 2 2 2 2 2 3 3 0 3 3 3 3 0 0 
 0 0 0 0 0 0 0 0 0 0 0 0 0 0 0 0 0 0 0 0 0 0 0 0 0 0 0 0 0 0 0 0 
 0 0 0 0 0 0 0 0 0 0 0 0 0 0 0 0 0 0 0 0 0 0 0 0 0 0 0 0 0 0 0 0 

